1111111131
1000000001
1000010001
1001110001
1000010001
1000010001
1001111101
1000000001
3000000003
1111311111