1111111111
1000010001
1000110001
1001010001
1011111001
1000010001
1000010001
1000000001
3000000001
1111111111