1111111111
1000000001
1001111001
1000001001
1001111001
1000001001
1001111001
1000000001
1000000003
1111111111