1111311111
1000000001
1001111001
1001000001
1001111001
1000001001
1001111001
1000000001
1000000001
1111111111